################
# #F        H   #
#S# #####  ### #
#      #       #
##### ######## ######
#####     H       # #
#####################