#######
#S#   #
# # # #
# # # #
# # #F#
#     #
#######