#########################################
#S#       #                # # #    # # #
# # # ### # ######## ##### # # # ## #   #
# # # # # # #      # # # # #   # #  ## ##
# ### # #   # ####   #   # # # # # #    #
#  H  # # # # # ## # ### # # # # # #### #
# ### # # #####    # #   # # # # #      #
# # # #   #     #### # ### # # # # ######
# # # # # # ### #    #   #   # #F#      #
#   # # # # # # # ###### # # # ######## #
### # # # # # # # # ## # # # #     #  # #
# # # # # ### #   #      # # # # # ## # #
# # # # # #   # # #####   H# # ### ## # #
# ### # ### ### #       ## ##### # ## # #
#     #         ##########     #        #
#########################################