#######
#S#   #
# #H# #
# # # #
# # #F#
#     #
#######