#######################################
#                    S                #
# # ############################### # #
# # #   #   #   #    F      #       # #
# # ###### ### ####### ### ### ### ## #
# # #           #       #       #   # #
# # # ############## ############# ## #
# # #       #   #       #           # #
# # ###### ####### ####### ########## #
# # #               #           #   # #
# # # ######## ####### ### ######## # #
# # #   #   #   #   #   #   #       # #
# # ## ####### ####### ####### ###### #
# # #       #           #       #   # #
# # ###### ############### ########## #
# # #   #       #   #       #   #   # #
# # ## ####### ####### ########### ## #
# # #   #   #           #   #   #   # #
# # ############## ################## #
#                                     #
#######################################
