################################################
#                    S                         #
# ############################################ #
# #                  F#                      # #
# # ######################################## # #
# # #                                        # #
# # # ######################################## #
# # #                                        # #
# # ######################################## # #
# #                 #                        # #
# # ################# ######################## #
# # #                                          #
# # ########################################## #
# #                                          # #
# # ########################################## #
# #                                          # #
# ########################################## # #
# #                                          # #
# # ########################################## #
# #                                          # #
# ########################################## # #
# #                                          # #
### ########################################## #
#                                              #
################################################
